"1" = "10"
"2" = "4"
"3" = "5"
"4" = "0"
"5" = "0"
"6" = "0"
"7" = "0"
